11111111111
10000010001
10101010101
E0101000101
10111110101
10101000101
10001010101
11111010101
101M1010101
10000010101
11111111111
